key	text	tooltip
factions_senator_text_n_out_of_n_troy_main_trj_maeonian_rebels		true
factions_defend_desc_troy_main_dan_aeolian_rebels	You are defending against the Shekelesh!	true
factions_senator_text_n_out_of_n_troy_main_dan_achaean_rebels		true
factions_screen_name_when_shogun_troy_main_dan_antheada	placeholder	true
factions_screen_name_troy_main_dan_pylos	Pylos	true
factions_clan_summary_name_when_shogun_troy_main_dan_knossos	placeholder	true
factions_clan_summary_name_troy_main_dan_asia	placeholder	true
factions_screen_adjective_troy_main_dan_dionysias	Dionysias	true
factions_screen_name_when_rebels_troy_main_dan_ellopians	Ionian Rebels	true
factions_senator_text_n_out_of_n_troy_main_dan_asia		true
factions_clan_summary_name_when_shogun_troy_main_trj_agriophones	placeholder	true
factions_defend_desc_troy_main_dan_aetolians	You are defending against the Aetolians!	true
factions_screen_name_when_shogun_troy_main_trj_hector	placeholder	true
factions_senator_text_n_out_of_n_troy_main_dan_dolopia		true
factions_defend_desc_troy_main_dan_rhodes	You are defending against Rhodes!	true
factions_attack_desc_troy_main_trj_alazones	You are attacking the Alazones!	true
factions_senator_text_n_out_of_n_troy_main_trj_maeonians		true
factions_clan_summary_name_when_shogun_troy_main_dan_arcadians_tutorial	placeholder	true
factions_attack_desc_troy_amazons_trj_penthesilea	You are attacking Penthesilea's Amazons!	true
factions_screen_adjective_troy_main_trj_cyclops	Cyclops	true
factions_screen_name_when_rebels_troy_main_dan_aeolian_rebels	Shekelesh	true
factions_screen_adjective_troy_main_trj_dardania	Dardanian	true
factions_attack_desc_troy_main_dan_ionian_rebels	You are attacking Denyen of the Sea!	true
factions_screen_name_when_rebels_troy_main_trj_aethria	Pelasgian Rebels	true
factions_defend_desc_troy_main_dan_esperia	You are defending against Esperia!	true
factions_clan_summary_name_troy_main_dan_dorian_rebels	placeholder	true
factions_clan_summary_name_when_shogun_troy_main_trj_tlawa	placeholder	true
factions_senator_text_n_out_of_n_troy_main_trj_alazones		true
factions_screen_name_troy_main_dan_epirotes	Epirotes	true
factions_clan_summary_name_when_shogun_troy_main_dan_antheada	placeholder	true
factions_attack_desc_troy_main_dan_rhodes	You are attacking Rhodes!	true
factions_clan_summary_name_when_shogun_troy_main_dan_tantalis	placeholder	true
factions_attack_desc_troy_main_dan_dolopia	You are attacking Dolopia!	true
factions_screen_name_troy_main_dan_argos	Argos	true
factions_screen_name_when_rebels_troy_main_trj_pelasgians_rebels	Peleset (Pelasgian Rebels)	true
factions_screen_name_when_shogun_att_fact_red	placeholder	true
factions_senator_text_n_out_of_n_troy_main_dan_athina		true
factions_screen_adjective_troy_main_dan_miletus	Miletus	true
factions_screen_name_when_rebels_troy_main_dan_ephesos	Achaean Rebels	true
factions_attack_desc_troy_main_dan_makaria	You are attacking Makaria!	true
factions_defend_desc_troy_main_trj_paris	You are defending against Paris' Trojans!	true
factions_clan_summary_name_when_shogun_troy_main_dan_athina	placeholder	true
factions_screen_adjective_troy_main_trj_agriophones	Agriophonian	true
factions_clan_summary_name_troy_main_dan_ionia	placeholder	true
factions_clan_summary_name_when_shogun_troy_main_dan_dorian_rebels	placeholder	true
factions_screen_name_troy_main_dan_ozolian_loc	Ozolian Locris	true
factions_screen_name_troy_main_dan_chersonesos	Chersonesos	true
factions_attack_desc_troy_main_dan_troizen	You are attacking Troizen!	true
factions_screen_name_troy_main_trj_ilion	Ilion Hyrtacidae	true
factions_defend_desc_troy_main_dan_sparta	You are defending against Sparta!	true
factions_clan_summary_name_troy_main_dan_dolopia	placeholder	true
factions_screen_name_when_rebels_att_fact_blue	Blue	true
factions_screen_name_when_rebels_troy_main_dan_aethaleia	Aeolian Rebels	true
factions_attack_desc_troy_main_trj_methymna	You are attacking Methymna!	true
factions_defend_desc_troy_main_dan_aethaleia	You are defending against Aethaleia!	true
factions_defend_desc_troy_main_dan_pylos_tutorial	You are defending against Pylos!	true
factions_screen_name_when_shogun_troy_main_dan_pylos	placeholder	true
factions_screen_name_when_shogun_troy_main_dan_cassopaei	placeholder	true
factions_defend_desc_troy_main_dan_teleboans	You are defending against the Teleboans!	true
factions_senator_text_n_out_of_n_troy_main_trj_manyan_phry		true
factions_senator_text_n_out_of_n_troy_main_trj_paphlagonians		true
factions_senator_text_n_out_of_n_troy_main_dan_corinthians		true
factions_senator_text_n_out_of_n_troy_main_trj_ascanian_phry		true
factions_screen_name_troy_main_dan_dolopia	Dolopia	true
factions_screen_name_troy_main_dan_ionia	Ionia	true
factions_screen_name_when_shogun_troy_main_trj_paris_separatists	placeholder	true
factions_screen_name_when_rebels_troy_main_dan_arcadians	Achaean Rebels	true
factions_screen_name_troy_main_dan_miletus	Miletus	true
factions_screen_name_when_rebels_troy_main_dan_arcadians_tutorial	Achaean Rebels	true
factions_defend_desc_troy_main_trj_agriophones	You are defending against the Agriophones tribe!	true
factions_clan_summary_name_when_shogun_troy_main_dan_phaiacians	placeholder	true
factions_senator_text_n_out_of_n_troy_main_dan_macednon		true
factions_clan_summary_name_troy_main_dan_anemoessa	placeholder	true
factions_defend_desc_troy_main_dan_mycenae_separatists	You are defending against the Mycenaean Noble Pretenders!	true
factions_screen_name_troy_main_trj_cyclops	Cyclops	true
factions_screen_name_when_rebels_troy_main_trj_mygdonians	Thracian Rebels	true
factions_senator_text_n_out_of_n_troy_main_dan_knossos		true
factions_screen_name_troy_main_dan_magnetes	Magnetes	true
factions_attack_desc_troy_main_dan_boeotians	You are attacking the Boeotians!	true
factions_senator_text_n_out_of_n_troy_main_dan_teleboans		true
factions_screen_name_troy_main_dan_narykos	Narykos	true
factions_clan_summary_name_troy_main_dan_ephesos	placeholder	true
factions_clan_summary_name_when_shogun_troy_main_trj_bottiaeans	placeholder	true
factions_clan_summary_name_troy_main_trj_bottiaeans	placeholder	true
factions_senator_text_n_out_of_n_troy_main_dan_sparta_separatists		true
factions_senator_text_n_out_of_n_troy_main_trj_lelegia_min		true
factions_senator_text_n_out_of_n_troy_main_dan_epidayrus		true
factions_screen_name_when_shogun_troy_main_dan_graea	placeholder	true
factions_attack_desc_troy_main_trj_hector_separatists	You are attacking  the Trojan Noble Pretenders!	true
factions_senator_text_n_out_of_n_troy_main_trj_ilion		true
factions_clan_summary_name_when_shogun_troy_main_dan_dolopia	placeholder	true
factions_screen_adjective_troy_main_trj_pelasgiotes	Pelasgian	true
factions_screen_name_when_rebels_troy_main_trj_dardania	Dardanian Loyalists	true
factions_screen_name_troy_main_dan_tiryns	Tiryns	true
factions_screen_name_when_shogun_troy_main_dan_boeotians	placeholder	true
factions_screen_name_when_rebels_att_fact_red	Red	true
factions_clan_summary_name_when_shogun_troy_main_dan_dindyma	placeholder	true
factions_defend_desc_troy_main_dan_athina	You are defending against Athina!	true
factions_screen_name_when_shogun_troy_main_trj_maeonians	placeholder	true
factions_screen_name_when_rebels_troy_main_trj_thrakes	Thracian Rebels	true
factions_clan_summary_name_troy_main_trj_carians	placeholder	true
factions_screen_name_troy_main_trj_lelegan_rebels	Lukka (Lycian Rebels)	true
factions_screen_name_when_rebels_troy_main_dan_meliboea	Aeolian Rebels	true
factions_clan_summary_name_troy_main_dan_kyme	placeholder	true
factions_defend_desc_troy_main_dan_pylos	You are defending against Pylos!	true
factions_screen_adjective_troy_main_trj_aethria	Aethrian	true
factions_screen_adjective_troy_main_trj_paris	Trojan	true
factions_defend_desc_troy_main_dan_mycenae	You are defending against Mycenae!	true
factions_screen_name_when_rebels_att_fact_yellow	Yellow	true
factions_screen_name_when_shogun_troy_main_dan_apaesos	placeholder	true
factions_screen_name_when_shogun_troy_main_dan_kyme	placeholder	true
factions_attack_desc_troy_main_dan_ithaca	You are attacking Ithaca!	true
factions_clan_summary_name_troy_main_dan_boeotians	placeholder	true
factions_defend_desc_troy_main_trj_ilion	You are defending against Ilion Hyrtacidae!	true
factions_screen_name_when_rebels_troy_main_dan_phyllis	Achaean Rebels	true
factions_screen_name_troy_main_dan_tantalis	Tantalis	true
factions_clan_summary_name_when_shogun_troy_main_dan_dionysias	placeholder	true
factions_screen_adjective_troy_main_dan_ozolian_loc	Ozolian Locris	true
factions_defend_desc_troy_main_trj_dardania	You are defending against Dardania	true
factions_screen_adjective_troy_main_dan_dolopians	Dolopian	true
factions_defend_desc_troy_main_dan_macednon	You are defending against Macednon!	true
factions_senator_text_n_out_of_n_troy_main_dan_dorians		true
factions_screen_adjective_troy_main_dan_arcadians	Arcadian	true
factions_defend_desc_troy_main_trj_thracian_rebels	You are defending against some unruly Thracians!	true
factions_screen_name_when_rebels_troy_main_trj_aenos	Thracian Rebels	true
factions_screen_name_troy_main_dan_troizen	Troizen	true
factions_attack_desc_troy_main_trj_edonia	You are attacking Edonia!	true
factions_senator_text_n_out_of_n_troy_main_dan_dindyma		true
factions_screen_adjective_troy_main_trj_tlawa	Tlawan	true
factions_screen_adjective_troy_main_trj_mygdonians	Mygdonian	true
factions_screen_name_troy_main_trj_mysia	Mysia	true
factions_defend_desc_troy_main_dan_phlegra	You are defending against Phlegra!	true
factions_attack_desc_troy_main_trj_maeonians_tml	You are attacking the Maeonians of Tmolos!	true
factions_screen_name_when_shogun_troy_main_dan_argos	placeholder	true
factions_clan_summary_name_when_shogun_troy_main_trj_maeonians	placeholder	true
factions_clan_summary_name_when_shogun_troy_main_dan_sparta_separatists	placeholder	true
factions_clan_summary_name_att_fact_yellow	placeholder	true
factions_screen_adjective_troy_main_dan_curetes	Curetes	true
factions_clan_summary_name_when_shogun_troy_main_dan_makaria	placeholder	true
factions_attack_desc_troy_main_dan_phaiacians	You are attacking the Phaiacians!	true
factions_clan_summary_name_troy_main_dan_phyllis	placeholder	true
factions_senator_text_n_out_of_n_troy_main_dan_miletus		true
factions_senator_text_n_out_of_n_troy_main_dan_ellopians		true
factions_clan_summary_name_troy_main_dan_teleboans	placeholder	true
factions_senator_text_n_out_of_n_troy_main_trj_edonia		true
factions_defend_desc_troy_main_trj_edonia	You are defending against Edonia!	true
factions_defend_desc_troy_main_dan_perrhaebi	You are defending against the Perrhaebi!	true
factions_screen_name_when_shogun_troy_amazons_trj_hippolyta	placeholder	true
factions_clan_summary_name_when_shogun_troy_main_dan_aethaleia	placeholder	true
factions_screen_name_when_rebels_troy_main_trj_aegaan_pel	Pelasgian Rebels	true
factions_clan_summary_name_troy_main_trj_lelegan_rebels	placeholder	true
factions_screen_name_troy_main_dan_phaiacians	Phaiacians	true
factions_screen_name_troy_main_dan_lapiths	Lapiths	true
factions_defend_desc_troy_main_trj_lelegia_min	You are defending against Lelegia Minoa!	true
factions_attack_desc_troy_main_trj_dardania_separatists	You are attacking  the Dardanian Noble Pretenders!	true
factions_clan_summary_name_when_shogun_att_fact_blue	placeholder	true
factions_clan_summary_name_when_shogun_troy_main_dan_mycenae_separatists	placeholder	true
factions_screen_name_when_rebels_troy_main_trj_carians	Lelegan Rebels	true
factions_defend_desc_troy_main_dan_achaean_rebels	You are defending against the Danaan Rebels!	true
factions_screen_name_when_shogun_troy_main_trj_ascanian_phry	placeholder	true
factions_screen_name_troy_main_trj_methymna	Methymna	true
factions_screen_name_when_rebels_troy_main_dan_graea	Aeolian Rebels	true
factions_senator_text_n_out_of_n_troy_main_dan_ozolian_loc		true
factions_clan_summary_name_when_shogun_troy_main_dan_arcadians	placeholder	true
factions_clan_summary_name_when_shogun_troy_main_dan_achilles_separatists	placeholder	true
factions_clan_summary_name_troy_amazons_trj_penthesilea	placeholder	true
factions_attack_desc_troy_main_dan_graea	You are attacking Graea!	true
factions_clan_summary_name_when_shogun_troy_amazons_trj_penthesilea	placeholder	true
factions_screen_name_when_rebels_troy_main_trj_thracian_rebels	Unruly Thracians	true
factions_clan_summary_name_when_shogun_troy_main_dan_mycenae	placeholder	true
factions_screen_name_troy_main_trj_pelasgiotes	Pelasgiotes	true
factions_attack_desc_troy_main_trj_cyclops	You are attacking the Cyclops!	true
factions_clan_summary_name_troy_main_dan_aethaleia	placeholder	true
factions_attack_desc_troy_main_dan_kyme	You are attacking Kyme!	true
factions_senator_text_n_out_of_n_troy_main_trj_paris		true
factions_screen_name_when_rebels_troy_main_trj_mysia	Thracian Rebels	true
factions_screen_adjective_troy_main_trj_pelasgians_rebels	Pelasgian	true
factions_screen_name_when_shogun_troy_main_trj_thyni	placeholder	true
factions_clan_summary_name_troy_main_dan_cassopaei	placeholder	true
factions_senator_text_n_out_of_n_att_fact_red		true
factions_senator_text_n_out_of_n_troy_main_dan_arcadians		true
factions_screen_name_troy_main_dan_corinthians	Corinthians	true
factions_clan_summary_name_when_shogun_troy_main_dan_perrhaebi	placeholder	true
factions_screen_name_when_shogun_troy_main_trj_ilion	placeholder	true
factions_clan_summary_name_troy_main_trj_imbrasos	placeholder	true
factions_clan_summary_name_troy_main_dan_chersonesos	placeholder	true
factions_clan_summary_name_troy_main_dan_narykos	placeholder	true
factions_clan_summary_name_when_shogun_att_fact_yellow	placeholder	true
factions_clan_summary_name_troy_main_trj_tlawa	placeholder	true
factions_screen_adjective_att_fact_blue	Blue	true
factions_screen_name_when_shogun_troy_main_dan_salamis	placeholder	true
factions_screen_name_when_rebels_troy_main_dan_troizen	Achaean Rebels	true
factions_screen_name_when_shogun_troy_main_trj_maeonians_tml	placeholder	true
factions_screen_adjective_troy_main_dan_antheada	Antheadan	true
factions_screen_name_when_rebels_troy_main_dan_phaiacians	Dorian Rebels	true
factions_screen_name_when_shogun_troy_main_dan_noagria	placeholder	true
factions_attack_desc_troy_main_dan_ozolian_loc	You are attacking Ozolian Locris!	true
factions_screen_name_troy_main_dan_epidayrus	Akis	true
factions_defend_desc_troy_main_trj_imbrasos	You are defending against Ilion Imbrasos!	true
factions_screen_adjective_troy_amazons_trj_hippolyta	Amazon	true
factions_clan_summary_name_troy_main_trj_tereia	placeholder	true
factions_clan_summary_name_troy_main_dan_aetolians	placeholder	true
factions_attack_desc_troy_main_trj_thracian_rebels	You are attacking some unruly Thracians!	true
factions_screen_name_when_rebels_troy_main_dan_knossos	Achaean Rebels	true
factions_clan_summary_name_troy_main_trj_agriophones	placeholder	true
factions_clan_summary_name_troy_main_dan_abantes	placeholder	true
factions_senator_text_n_out_of_n_troy_main_dan_phaiacians		true
factions_senator_text_n_out_of_n_troy_main_dan_ionian_rebels		true
factions_screen_adjective_troy_main_dan_ionia	Ionian	true
factions_screen_name_when_rebels_troy_main_dan_antheada	Achaean Rebels	true
factions_clan_summary_name_troy_main_dan_achilles_separatists	placeholder	true
factions_screen_name_when_rebels_troy_main_dan_salamis	Achaean Rebels	true
factions_screen_name_troy_main_dan_thessalians	Thessalians	true
factions_screen_name_when_shogun_troy_main_dan_tantalis	placeholder	true
factions_clan_summary_name_troy_main_dan_dionysias	placeholder	true
factions_clan_summary_name_troy_main_dan_apteron	placeholder	true
factions_screen_adjective_troy_main_dan_elis	Elis	true
factions_clan_summary_name_when_shogun_troy_main_dan_apteron	placeholder	true
factions_senator_text_n_out_of_n_troy_main_dan_dionysias		true
factions_screen_name_when_shogun_troy_main_trj_aethria	placeholder	true
factions_screen_name_when_shogun_troy_main_trj_methymna	placeholder	true
factions_senator_text_n_out_of_n_troy_main_dan_cassopaei		true
factions_screen_name_when_rebels_troy_main_trj_paeonians	Thracian Rebels	true
factions_senator_text_n_out_of_n_troy_main_trj_dardania		true
factions_attack_desc_troy_main_dan_magnetes	You are attacking the Magnetes!	true
factions_screen_adjective_troy_main_dan_anemoessa	Anemoessan	true
factions_screen_name_when_shogun_troy_main_dan_tiryns	placeholder	true
factions_screen_name_when_rebels_troy_main_trj_troy	Trojan Loyalists	true
factions_screen_name_troy_main_dan_arcadians_tutorial	Arcadians	true
factions_clan_summary_name_troy_main_trj_methymna	placeholder	true
factions_screen_name_troy_main_dan_phyllis	Phyllis	true
factions_clan_summary_name_when_shogun_troy_main_dan_ellopians	placeholder	true
factions_screen_name_troy_main_dan_ionian_rebels	Denyen of the Sea	true
factions_screen_name_when_rebels_troy_main_dan_apaesos	Aeolian Rebels	true
factions_defend_desc_troy_main_dan_meliboea	You are defending against Meliboea!	true
factions_defend_desc_troy_main_dan_tantalis	You are defending against Tantalis!	true
factions_screen_adjective_troy_main_dan_narykos	Narykos	true
factions_senator_text_n_out_of_n_troy_main_dan_sparta		true
factions_senator_text_n_out_of_n_troy_main_trj_methymna		true
factions_screen_name_when_shogun_troy_main_trj_pelasgians_rebels	placeholder	true
factions_defend_desc_troy_main_dan_dorian_rebels	You are defending against the Dorian Rebels!	true
factions_defend_desc_troy_main_dan_sparta_separatists	You are defending against the Spartan Noble Pretenders!	true
factions_clan_summary_name_when_shogun_troy_main_dan_magnetes	placeholder	true
factions_screen_adjective_troy_main_dan_ithaca	Ithaca	true
factions_screen_name_when_shogun_troy_main_dan_elis	placeholder	true
factions_screen_name_when_rebels_troy_main_dan_achaean_rebels	Danaan Rebels	true
factions_attack_desc_troy_main_dan_chersonesos	You are attacking Chersonesos!	true
factions_defend_desc_troy_main_trj_aethria	You are defending against Aethria!	true
factions_clan_summary_name_when_shogun_troy_main_dan_tiryns	placeholder	true
factions_screen_name_when_shogun_troy_main_dan_esperia	placeholder	true
factions_clan_summary_name_troy_main_dan_arcadians	placeholder	true
factions_clan_summary_name_when_shogun_troy_main_dan_macednon	placeholder	true
factions_screen_name_when_rebels_troy_main_trj_paphlagonians	Maeonian Rebels	true
factions_clan_summary_name_when_shogun_troy_main_dan_peraia	placeholder	true
factions_defend_desc_troy_main_dan_narykos	You are defending against Narykos!	true
factions_clan_summary_name_troy_main_trj_ilion	placeholder	true
factions_clan_summary_name_when_shogun_troy_main_trj_imbrasos	placeholder	true
factions_clan_summary_name_when_shogun_troy_main_dan_phyllis	placeholder	true
factions_attack_desc_troy_main_trj_aethria	You are attacking Aethria!	true
factions_screen_adjective_troy_main_dan_perrhaebi	Perrhaebi	true
factions_senator_text_n_out_of_n_troy_main_trj_maeonians_tml		true
factions_screen_name_when_shogun_troy_main_trj_carians	placeholder	true
factions_defend_desc_troy_main_trj_paris_separatists	You are defending against the Trojan Royal Pretenders!	true
factions_clan_summary_name_troy_main_trj_apsynthioi	placeholder	true
factions_clan_summary_name_troy_amazons_trj_hippolyta	placeholder	true
factions_screen_name_troy_main_trj_thrakes	Thrakes	true
factions_senator_text_n_out_of_n_troy_main_dan_ephesos		true
factions_clan_summary_name_troy_main_dan_magnetes	placeholder	true
factions_clan_summary_name_troy_main_dan_graea	placeholder	true
factions_attack_desc_troy_main_dan_narykos	You are attacking Narykos!	true
factions_screen_name_when_rebels_troy_main_dan_peraia	Ionian Rebels	true
factions_screen_name_when_shogun_troy_main_dan_ellopians	placeholder	true
factions_screen_adjective_troy_main_trj_aenos	Aenos	true
factions_senator_text_n_out_of_n_troy_main_dan_ionia		true
factions_screen_adjective_troy_main_dan_ionian_rebels	Denyen	true
factions_clan_summary_name_when_shogun_troy_main_trj_methymna	placeholder	true
factions_screen_name_when_rebels_troy_main_dan_noagria	Achaean Rebels	true
factions_clan_summary_name_when_shogun_troy_main_trj_bithyni	placeholder	true
factions_senator_text_n_out_of_n_troy_main_dan_aethaleia		true
factions_screen_name_when_rebels_troy_main_trj_tereia	Pelasgian Rebels	true
factions_defend_desc_troy_main_trj_hector	You are defending against Hector's Trojans!	true
factions_clan_summary_name_when_shogun_troy_main_dan_elis	placeholder	true
factions_clan_summary_name_troy_main_dan_rhodes	placeholder	true
factions_clan_summary_name_troy_main_trj_maeonians	placeholder	true
factions_clan_summary_name_when_shogun_troy_main_dan_achaean_rebels	placeholder	true
factions_screen_name_troy_amazons_trj_penthesilea	Penthesilea's Amazons	true
factions_attack_desc_troy_main_trj_carians	You are attacking the Carians!	true
factions_defend_desc_troy_main_dan_cassopaei	You are defending against the Cassopaei tribe!	true
factions_screen_name_when_shogun_troy_main_trj_bottiaeans	placeholder	true
factions_screen_name_troy_main_dan_athina	Athina	true
factions_attack_desc_troy_amazons_trj_hippolyta	You are attacking Hippolyta's Amazons!	true
factions_screen_adjective_troy_main_trj_hector	Trojan	true
factions_senator_text_n_out_of_n_att_fact_yellow		true
factions_screen_name_troy_main_trj_cicones	Cicones	true
factions_screen_name_when_shogun_troy_main_dan_dolopia	placeholder	true
factions_defend_desc_troy_main_dan_ithaca_separatists	You are defending against the Ithacan Noble Pretenders!	true
factions_screen_name_troy_main_dan_sparta_separatists	Spartan Noble Pretenders	true
factions_screen_name_troy_amazons_trj_hippolyta	Hippolyta's Amazons	true
factions_screen_name_when_shogun_troy_main_trj_bisaltae	placeholder	true
factions_screen_adjective_troy_main_dan_chersonesos	Chersonesos	true
factions_screen_name_when_rebels_troy_main_trj_agriophones	Pelasgian Rebels	true
factions_clan_summary_name_troy_main_dan_troizen	placeholder	true
factions_screen_name_when_rebels_troy_main_trj_lelegan_rebels	Lukka (Lycian Rebels)	true
factions_screen_name_when_shogun_troy_main_trj_paeonians	placeholder	true
factions_attack_desc_troy_main_trj_thyni	You are attacking the Thyni tribe!	true
factions_screen_adjective_troy_main_dan_graea	Graea	true
factions_clan_summary_name_troy_main_dan_mycenae_separatists	placeholder	true
factions_attack_desc_troy_main_trj_lelegia_min	You are attacking Lelegia Minoa!	true
factions_clan_summary_name_when_shogun_troy_main_dan_sparta	placeholder	true
factions_screen_adjective_att_fact_yellow	Yellow	true
factions_screen_name_when_shogun_troy_main_trj_pelasgiotes	placeholder	true
factions_screen_name_when_shogun_troy_main_trj_troy	placeholder	true
factions_screen_name_when_rebels_troy_main_dan_esperia	Aeolian Rebels	true
factions_attack_desc_troy_main_trj_maeonian_rebels	You are attacking the Maeonian Rebels!	true
factions_clan_summary_name_att_fact_blue	placeholder	true
factions_screen_name_when_rebels_troy_main_trj_bottiaeans	Pelasgian Rebels	true
factions_clan_summary_name_troy_main_trj_paeonians	placeholder	true
factions_screen_name_when_shogun_troy_main_trj_dardania_separatists	placeholder	true
factions_senator_text_n_out_of_n_troy_main_dan_lapiths		true
factions_attack_desc_troy_main_trj_cicones	You are attacking the Cicones!	true
factions_screen_name_att_fact_yellow	Yellow	true
factions_defend_desc_troy_main_trj_aenos	You are defending against Aenos!	true
factions_screen_name_when_shogun_troy_main_trj_imbrasos	placeholder	true
factions_clan_summary_name_when_shogun_troy_main_dan_cassopaei	placeholder	true
factions_screen_adjective_troy_main_dan_meliboea	Meliboean	true
factions_attack_desc_troy_main_trj_bottiaeans	You are attacking the Bottiaeans!	true
factions_attack_desc_troy_main_dan_lapiths	You are attacking the Lapiths!	true
factions_screen_adjective_troy_main_dan_mycenae	Mycenaean	true
factions_senator_text_n_out_of_n_troy_main_dan_anemoessa		true
factions_clan_summary_name_troy_main_trj_manyan_phry	placeholder	true
factions_clan_summary_name_when_shogun_troy_main_dan_corinthians	placeholder	true
factions_attack_desc_att_fact_blue	You are attacking Red Shield!	true
factions_clan_summary_name_troy_main_dan_athina	placeholder	true
factions_screen_name_troy_main_dan_aeolian_rebels	Shekelesh	true
factions_senator_text_n_out_of_n_troy_main_trj_carians		true
factions_screen_name_when_shogun_troy_main_dan_epidayrus	placeholder	true
factions_screen_adjective_troy_main_trj_thrakes	Thracian	true
factions_attack_desc_troy_main_trj_paris_separatists	You are attacking  the Trojan Royal Pretenders!	true
factions_screen_name_when_rebels_troy_main_trj_paris_separatists	Trojan Royal Pretenders	true
factions_attack_desc_troy_main_dan_dorian_rebels	You are attacking the Dorian Rebels!	true
factions_senator_text_n_out_of_n_troy_main_trj_agriophones		true
factions_screen_name_when_shogun_troy_main_dan_phlegra	placeholder	true
factions_senator_text_n_out_of_n_troy_main_dan_perrhaebi		true
factions_senator_text_n_out_of_n_troy_main_dan_curetes		true
factions_defend_desc_troy_main_trj_manyan_phry	You are defending against the Manyan Phrygians!	true
factions_clan_summary_name_troy_main_trj_aenos	placeholder	true
factions_clan_summary_name_troy_main_trj_thracian_rebels	placeholder	true
factions_screen_name_when_rebels_troy_main_trj_hector_separatists	Trojan Noble Pretenders	true
factions_senator_text_n_out_of_n_troy_main_trj_cicones		true
factions_clan_summary_name_troy_main_trj_mysia	placeholder	true
factions_attack_desc_troy_main_dan_salamis	You are attacking Salamis!	true
factions_screen_name_when_shogun_troy_main_trj_lycia_separatists	placeholder	true
factions_screen_adjective_troy_main_dan_ephesos	Ephesos	true
factions_screen_name_troy_main_dan_perrhaebi	Perrhaebi	true
factions_attack_desc_troy_main_trj_manyan_phry	You are attacking the Manyan Phrygians!	true
factions_senator_text_n_out_of_n_troy_main_trj_imbrasos		true
factions_clan_summary_name_when_shogun_troy_main_dan_asia	placeholder	true
factions_screen_name_troy_main_trj_maeonian_rebels	Maeonian Rebels	true
factions_screen_name_when_rebels_troy_main_dan_asia	Achaean Rebels	true
factions_clan_summary_name_troy_main_trj_aethria	placeholder	true
factions_defend_desc_troy_main_dan_tiryns	You are defending against Tiryns!	true
factions_defend_desc_troy_main_dan_arcadians_tutorial	You are defending against the Arcadians!	true
factions_senator_text_n_out_of_n_troy_main_trj_mygdonians		true
factions_senator_text_n_out_of_n_troy_main_dan_salamis		true
factions_screen_name_when_shogun_troy_main_dan_sparta	placeholder	true
factions_senator_text_n_out_of_n_troy_main_dan_kyme		true
factions_screen_name_when_rebels_troy_main_trj_paris	Paris' Loyalists	true
factions_screen_name_when_shogun_troy_main_dan_thessalians	placeholder	true
factions_clan_summary_name_when_shogun_troy_main_dan_curetes	placeholder	true
factions_clan_summary_name_when_shogun_troy_main_dan_epidayrus	placeholder	true
factions_screen_name_when_rebels_troy_main_dan_miletus	Achaean Rebels	true
factions_defend_desc_troy_main_trj_tereia	You are defending against Tereia!	true
factions_attack_desc_troy_main_trj_lelegan_rebels	You are attacking the Lukka (Lycian Rebels)!	true
factions_screen_name_when_rebels_troy_main_trj_maeonians	Maeonian Rebels	true
factions_attack_desc_troy_main_dan_esperia	You are attacking Esperia!	true
factions_clan_summary_name_when_shogun_troy_main_dan_abantes	placeholder	true
factions_screen_name_when_shogun_troy_main_dan_chersonesos	placeholder	true
factions_defend_desc_troy_main_trj_methymna	You are defending against Methymna!	true
factions_screen_name_when_rebels_troy_main_dan_curetes	Achaean Rebels	true
factions_screen_name_when_shogun_troy_main_trj_agriophones	placeholder	true
factions_clan_summary_name_when_shogun_troy_main_dan_phlegra	placeholder	true
factions_screen_name_when_shogun_troy_main_dan_narykos	placeholder	true
factions_screen_adjective_troy_main_trj_maeonians_tml	Maeonian	true
factions_clan_summary_name_when_shogun_troy_main_dan_kyme	placeholder	true
factions_senator_text_n_out_of_n_troy_main_trj_dardania_separatists		true
factions_defend_desc_troy_main_dan_thessalians	You are defending against the Thessalians!	true
factions_senator_text_n_out_of_n_troy_main_dan_magnetes		true
factions_attack_desc_troy_main_dan_tantalis	You are attacking Tantalis!	true
factions_defend_desc_troy_main_trj_cyclops	You are defending against the Cyclops!	true
factions_clan_summary_name_when_shogun_troy_main_dan_boeotians	placeholder	true
factions_screen_adjective_troy_main_dan_tiryns	Tiryns	true
factions_screen_adjective_troy_main_dan_achilles	Phthian	true
factions_attack_desc_troy_main_dan_dindyma	You are attacking Dindyma!	true
factions_clan_summary_name_when_shogun_troy_main_trj_paeonians	placeholder	true
factions_screen_name_when_shogun_troy_main_trj_cicones	placeholder	true
factions_screen_name_when_rebels_troy_main_dan_sparta_separatists	Spartan Noble Pretenders	true
factions_screen_name_troy_main_dan_kyme	Kyme	true
factions_attack_desc_troy_main_dan_elis	You are attacking Elis!	true
factions_clan_summary_name_when_shogun_troy_main_trj_thyni	placeholder	true
factions_attack_desc_troy_main_dan_apteron	You are attacking Apteron!	true
factions_defend_desc_troy_main_dan_achilles	You are defending against Phthia!	true
factions_attack_desc_troy_main_trj_bisaltae	You are attacking Bisaltae!	true
factions_screen_name_troy_main_dan_noagria	Noagria	true
factions_screen_name_when_rebels_troy_main_dan_tantalis	Achaean Rebels	true
factions_defend_desc_troy_main_dan_ionia	You are defending against Ionia!	true
factions_screen_name_troy_main_dan_achilles_separatists	Phthian Noble Pretenders	true
factions_defend_desc_troy_main_trj_paphlagonians	You are defending against the Paphlagonians!	true
factions_screen_adjective_troy_main_dan_epirotes	Epirotan	true
factions_screen_name_troy_main_dan_ithaca_separatists	Ithacan Noble Pretenders	true
factions_screen_name_troy_main_trj_paphlagonians	Paphlagonians	true
factions_screen_name_when_shogun_troy_main_dan_ionian_rebels	placeholder	true
factions_clan_summary_name_when_shogun_troy_main_dan_achilles	placeholder	true
factions_senator_text_n_out_of_n_troy_main_trj_tereia		true
factions_screen_name_when_shogun_troy_main_dan_athina	placeholder	true
factions_clan_summary_name_troy_main_trj_bithyni	placeholder	true
factions_screen_adjective_troy_main_trj_paris_separatists	Trojan Princes	true
factions_screen_name_troy_main_trj_lycia_separatists	Lycian Pretenders	true
factions_defend_desc_troy_main_trj_carians	You are defending against the Carians!	true
factions_attack_desc_troy_main_dan_aethaleia	You are attacking Aethaleia!	true
factions_defend_desc_troy_main_dan_curetes	You are defending against the Curetes!	true
factions_clan_summary_name_when_shogun_troy_main_dan_argos	placeholder	true
factions_clan_summary_name_when_shogun_troy_amazons_trj_hippolyta	placeholder	true
factions_screen_name_when_shogun_troy_main_dan_arcadians	placeholder	true
factions_senator_text_n_out_of_n_troy_main_trj_hector_separatists		true
factions_clan_summary_name_troy_main_dan_sparta_separatists	placeholder	true
factions_screen_adjective_troy_main_trj_bottiaeans	Bottiaean	true
factions_screen_name_troy_main_trj_agriophones	Agriophones	true
factions_attack_desc_troy_main_dan_athina	You are attacking Athina!	true
factions_defend_desc_troy_main_dan_argos	You are defending against Argos!	true
factions_clan_summary_name_troy_main_dan_ionian_rebels	placeholder	true
factions_attack_desc_troy_main_dan_asia	You are attacking Asia!	true
factions_clan_summary_name_when_shogun_troy_main_trj_maeonians_tml	placeholder	true
factions_screen_name_when_rebels_troy_main_trj_alazones	Maeonian Rebels	true
factions_clan_summary_name_when_shogun_troy_main_trj_lelegia_min	placeholder	true
factions_screen_name_troy_main_dan_salamis	Salamis	true
factions_screen_name_troy_main_trj_hector_separatists	Trojan Noble Pretenders	true
factions_screen_name_when_rebels_troy_amazons_trj_hippolyta	Amazon Rebels	true
factions_screen_name_when_shogun_troy_main_trj_aenos	placeholder	true
factions_defend_desc_troy_main_trj_ascanian_phry	You are defending against the Ascanian Phrygians!	true
factions_clan_summary_name_when_shogun_troy_main_trj_apsynthioi	placeholder	true
factions_screen_name_troy_main_trj_mygdonians	Mygdonians	true
factions_attack_desc_troy_main_dan_dionysias	You are attacking Dionysias!	true
factions_defend_desc_troy_main_dan_antheada	You are defending against Antheada!	true
factions_clan_summary_name_when_shogun_troy_main_trj_dardania_separatists	placeholder	true
factions_screen_name_troy_main_trj_aegaan_pel	Aegaan Pelasgians	true
factions_defend_desc_troy_main_dan_dionysias	You are defending against Dionysias!	true
factions_senator_text_n_out_of_n_troy_main_trj_lycia_separatists		true
factions_defend_desc_troy_main_dan_peraia	You are defending against Peraia!	true
factions_screen_name_when_rebels_troy_main_dan_achilles_separatists	Phthian Noble Pretenders	true
factions_screen_name_when_shogun_troy_main_trj_paris	placeholder	true
factions_screen_adjective_troy_main_dan_aethaleia	Aethaleian	true
factions_screen_adjective_troy_main_trj_hector_separatists	Trojan Nobles	true
factions_screen_name_troy_main_dan_rhodes	Rhodes	true
factions_defend_desc_troy_main_trj_lycia_separatists	You are defending against the Lycian Noble Pretenders!	true
factions_screen_adjective_troy_amazons_trj_penthesilea	Amazon	true
factions_screen_name_when_rebels_troy_main_dan_boeotians	Aeolian Rebels	true
factions_screen_adjective_troy_main_dan_boeotians	Boeotian	true
factions_screen_adjective_troy_main_trj_lelegan_rebels	Lukkan	true
factions_clan_summary_name_when_shogun_troy_main_trj_paris	placeholder	true
factions_defend_desc_troy_main_dan_dolopia	You are defending against Dolopia!	true
factions_clan_summary_name_troy_main_trj_maeonian_rebels	placeholder	true
factions_clan_summary_name_troy_main_dan_dindyma	placeholder	true
factions_attack_desc_troy_main_dan_mycenae	You are attacking Mycenae!	true
factions_screen_name_when_rebels_troy_main_dan_ionia	Ionian Rebels	true
factions_screen_name_troy_main_dan_sparta	Sparta	true
factions_screen_name_when_rebels_troy_main_dan_apteron	Achaean Rebels	true
factions_senator_text_n_out_of_n_troy_main_trj_paeonians		true
factions_clan_summary_name_when_shogun_troy_main_dan_chersonesos	placeholder	true
factions_screen_name_when_rebels_troy_main_trj_apsynthioi	Thracian Rebels	true
factions_screen_name_troy_main_dan_achaean_rebels	Danaan Rebels	true
factions_clan_summary_name_when_shogun_troy_main_trj_aenos	placeholder	true
factions_clan_summary_name_troy_main_dan_perrhaebi	placeholder	true
factions_defend_desc_troy_main_dan_phyllis	You are defending against Phyllis!	true
factions_screen_adjective_troy_main_dan_dorians	Dorian	true
factions_screen_name_when_rebels_troy_main_trj_imbrasos	Pelasgian Rebels	true
factions_screen_name_when_shogun_troy_main_dan_aethaleia	placeholder	true
factions_screen_name_when_shogun_troy_main_dan_epirotes	placeholder	true
factions_defend_desc_troy_main_dan_graea	You are defending against Graea!	true
factions_screen_adjective_troy_main_dan_lapiths	Lapith	true
factions_screen_name_when_shogun_troy_main_trj_lycia	placeholder	true
factions_screen_adjective_troy_main_dan_esperia	Esperian	true
factions_screen_adjective_troy_main_dan_troizen	Troizen	true
factions_clan_summary_name_troy_main_dan_meliboea	placeholder	true
factions_screen_name_when_shogun_troy_main_trj_hector_separatists	placeholder	true
factions_screen_name_when_rebels_troy_main_dan_pylos	Achaean Rebels	true
factions_screen_name_when_rebels_troy_main_trj_manyan_phry	Thracian Rebels	true
factions_attack_desc_troy_main_trj_thrakes	You are attacking the Thrakes!	true
factions_attack_desc_troy_main_trj_hector	You are attacking Hector's Trojans!	true
factions_screen_adjective_troy_main_trj_ascanian_phry	Ascanian	true
factions_senator_text_n_out_of_n_troy_main_dan_aeolian_rebels		true
factions_screen_name_when_shogun_troy_main_trj_cyclops	placeholder	true
factions_defend_desc_troy_main_trj_maeonians_tml	You are defending against the Maeonians of Tmolos!	true
factions_screen_name_when_shogun_troy_main_trj_aegaan_pel	placeholder	true
factions_screen_name_when_rebels_troy_main_dan_epirotes	Dorian Rebels	true
factions_screen_name_when_shogun_troy_main_dan_achilles	placeholder	true
factions_senator_text_n_out_of_n_troy_main_dan_antheada		true
factions_screen_name_when_rebels_troy_main_dan_ionian_rebels	Denyen of the Sea	true
factions_senator_text_n_out_of_n_troy_main_dan_dolopians		true
factions_screen_name_when_rebels_troy_main_dan_elis	Achaean Rebels	true
factions_screen_adjective_troy_main_dan_apaesos	Apaesos	true
factions_screen_name_when_rebels_troy_main_trj_thyni	Thracian Rebels	true
factions_senator_text_n_out_of_n_troy_main_trj_tlawa		true
factions_defend_desc_att_fact_yellow	You are defending against Red Shield!	true
factions_screen_name_when_shogun_troy_main_dan_teleboans	placeholder	true
factions_screen_name_when_shogun_troy_main_dan_triopion	placeholder	true
factions_defend_desc_troy_amazons_trj_hippolyta	You are defending against Hippolyta's Amazons!	true
factions_screen_name_troy_main_dan_antheada	Antheada	true
factions_screen_name_troy_main_trj_tereia	Tereia	true
factions_senator_text_n_out_of_n_troy_main_trj_pelasgiotes		true
factions_clan_summary_name_troy_main_trj_pelasgians_rebels	placeholder	true
factions_clan_summary_name_troy_main_trj_mygdonians	placeholder	true
factions_screen_name_when_rebels_troy_main_trj_cyclops	Pelasgian Rebels	true
factions_clan_summary_name_when_shogun_troy_main_dan_thessalians	placeholder	true
factions_clan_summary_name_when_shogun_troy_main_dan_teleboans	placeholder	true
factions_screen_adjective_troy_main_dan_asia	Asian	true
factions_screen_name_when_shogun_troy_main_trj_mysia	placeholder	true
factions_screen_name_when_shogun_troy_main_dan_achilles_separatists	placeholder	true
factions_screen_adjective_troy_main_trj_aegaan_pel	Aegaan	true
factions_screen_name_when_shogun_troy_main_dan_ozolian_loc	placeholder	true
factions_defend_desc_troy_main_trj_pelasgiotes	You are defending against the Pelasgiotes!	true
factions_senator_text_n_out_of_n_troy_main_dan_apteron		true
factions_attack_desc_troy_main_dan_epidayrus	You are attacking Epidayrus!	true
factions_screen_adjective_troy_main_dan_athina	Athenian	true
factions_screen_name_when_rebels_troy_main_dan_abantes	Ionian Rebels	true
factions_clan_summary_name_troy_main_trj_alazones	placeholder	true
factions_screen_name_when_rebels_troy_main_dan_ithaca	Ithacan Loyalists	true
factions_senator_text_n_out_of_n_troy_main_trj_aethria		true
factions_screen_name_when_shogun_troy_main_dan_makaria	placeholder	true
factions_attack_desc_troy_main_trj_pelasgians_rebels	You are attacking the Peleset (Pelasgian Rebels)!	true
factions_attack_desc_troy_main_dan_teleboans	You are attacking the Teleboans!	true
factions_attack_desc_troy_main_trj_ascanian_phry	You are attacking the Ascanian Phrygians!	true
factions_screen_name_when_shogun_troy_main_dan_sparta_separatists	placeholder	true
factions_screen_adjective_troy_main_dan_achaean_rebels	Danaan	true
factions_screen_name_when_shogun_troy_main_dan_ithaca	placeholder	true
factions_attack_desc_att_fact_red	You are attacking Red Shield!	true
factions_attack_desc_troy_main_dan_tiryns	You are attacking Tiryns!	true
factions_attack_desc_troy_main_trj_ilion	You are attacking Ilion Hyrtacidae!	true
factions_clan_summary_name_when_shogun_troy_main_dan_ozolian_loc	placeholder	true
factions_senator_text_n_out_of_n_troy_main_dan_phlegra		true
factions_attack_desc_troy_main_dan_ellopians	You are attacking the Ellopians!	true
factions_clan_summary_name_troy_main_trj_cyclops	placeholder	true
factions_clan_summary_name_troy_main_dan_tantalis	placeholder	true
factions_senator_text_n_out_of_n_troy_main_dan_aetolians		true
factions_screen_name_troy_main_trj_troy	Troy	true
factions_clan_summary_name_troy_main_dan_esperia	placeholder	true
factions_screen_name_when_rebels_troy_main_trj_edonia	Thracian Rebels	true
factions_defend_desc_troy_main_trj_bisaltae	You are defending against Bisaltae!	true
factions_clan_summary_name_troy_main_dan_pylos_tutorial	placeholder	true
factions_attack_desc_troy_main_dan_pylos_tutorial	You are attacking Pylos!	true
factions_clan_summary_name_when_shogun_troy_main_dan_troizen	placeholder	true
factions_senator_text_n_out_of_n_att_fact_blue		true
factions_defend_desc_troy_main_trj_maeonians	You are defending against the Maeonians!	true
factions_defend_desc_troy_main_dan_phaiacians	You are defending against the Phaiacians!	true
factions_clan_summary_name_troy_main_dan_peraia	placeholder	true
factions_screen_adjective_troy_main_dan_ithaca_separatists	Ithacan Nobles	true
factions_senator_text_n_out_of_n_troy_main_trj_thracian_rebels		true
factions_clan_summary_name_troy_main_dan_corinthians	placeholder	true
factions_defend_desc_troy_main_dan_anemoessa	You are defending against Anemoessa!	true
factions_screen_name_troy_main_dan_cassopaei	Cassopaei	true
factions_screen_adjective_troy_main_dan_sparta_separatists	Spartan Nobles	true
factions_defend_desc_troy_main_dan_apaesos	You are defending against Apaesos!	true
factions_defend_desc_troy_main_trj_cicones	You are defending against the Cicones!	true
factions_screen_name_when_rebels_troy_main_trj_bithyni	Thracian Rebels	true
factions_screen_name_troy_main_trj_lelegia_min	Lelegia Minoa	true
factions_defend_desc_troy_main_dan_apteron	You are defending against Apteron!	true
factions_defend_desc_troy_main_trj_bottiaeans	You are defending against the Bottiaeans!	true
factions_screen_name_when_shogun_troy_main_dan_asia	placeholder	true
factions_screen_adjective_troy_main_trj_imbrasos	Imbrasos	true
factions_attack_desc_troy_main_dan_macednon	You are attacking Macednon!	true
factions_senator_text_n_out_of_n_troy_main_trj_bisaltae		true
factions_screen_adjective_troy_main_dan_achilles_separatists	Phthian Nobles	true
factions_clan_summary_name_troy_main_trj_pelasgiotes	placeholder	true
factions_clan_summary_name_troy_main_dan_argos	placeholder	true
factions_clan_summary_name_when_shogun_troy_main_dan_ionia	placeholder	true
factions_screen_name_troy_main_trj_imbrasos	Ilion Imbrasos	true
factions_clan_summary_name_troy_main_trj_thyni	placeholder	true
factions_defend_desc_troy_main_dan_lapiths	You are defending against the Lapiths!	true
factions_senator_text_n_out_of_n_troy_main_dan_minyes		true
factions_screen_name_troy_main_trj_manyan_phry	Manyan Phrygians	true
factions_screen_name_when_shogun_troy_main_dan_ionia	placeholder	true
factions_screen_name_when_rebels_troy_main_trj_ilion	Pelasgian Rebels	true
factions_senator_text_n_out_of_n_troy_main_trj_apsynthioi		true
factions_screen_adjective_troy_main_trj_thracian_rebels	Thracian	true
factions_clan_summary_name_when_shogun_troy_main_trj_lycia_separatists	placeholder	true
factions_clan_summary_name_troy_main_dan_triopion	placeholder	true
factions_screen_name_when_rebels_troy_main_trj_maeonian_rebels	Maeonian Rebels	true
factions_attack_desc_troy_main_dan_perrhaebi	You are attacking the Perrhaebi!	true
factions_clan_summary_name_troy_main_dan_tiryns	placeholder	true
factions_defend_desc_troy_main_trj_lelegan_rebels	You are defending against the Lukka (Lycian Rebels)!	true
factions_screen_adjective_troy_main_trj_bisaltae	Bisaltae	true
factions_senator_text_n_out_of_n_troy_main_dan_achilles_separatists		true
factions_screen_name_when_shogun_troy_main_trj_bithyni	placeholder	true
factions_screen_name_when_rebels_troy_main_trj_cicones	Thracian Rebels	true
factions_screen_name_when_shogun_troy_main_trj_dardania	placeholder	true
factions_defend_desc_troy_main_dan_noagria	You are defending against Noagria!	true
factions_clan_summary_name_when_shogun_att_fact_red	placeholder	true
factions_screen_name_when_shogun_troy_main_dan_minyes	placeholder	true
factions_defend_desc_troy_main_trj_mysia	You are defending against Mysia!	true
factions_screen_name_when_rebels_troy_main_dan_dolopia	Aeolian Rebels	true
factions_clan_summary_name_troy_main_dan_miletus	placeholder	true
factions_screen_name_troy_main_dan_dindyma	Dindyma	true
factions_clan_summary_name_troy_main_trj_dardania	placeholder	true
factions_senator_text_n_out_of_n_troy_main_dan_phyllis		true
factions_attack_desc_troy_main_trj_lycia_separatists	You are attacking  the Lycian Noble Pretenders!	true
factions_screen_name_when_shogun_troy_main_dan_abantes	placeholder	true
factions_attack_desc_troy_main_dan_antheada	You are attacking Antheada!	true
factions_screen_name_when_rebels_troy_main_dan_ithaca_separatists	Ithacan Noble Pretenders	true
factions_screen_name_when_shogun_troy_main_trj_thracian_rebels	placeholder	true
factions_senator_text_n_out_of_n_troy_main_dan_peraia		true
factions_senator_text_n_out_of_n_troy_main_dan_troizen		true
factions_screen_name_when_shogun_troy_main_dan_miletus	placeholder	true
factions_attack_desc_troy_main_dan_phlegra	You are attacking Phlegra!	true
factions_screen_name_when_rebels_troy_main_trj_pelasgiotes	Pelasgian Rebels	true
factions_screen_adjective_troy_main_trj_mysia	Mysian	true
factions_screen_adjective_troy_main_dan_apteron	Apteron	true
factions_attack_desc_troy_main_dan_dolopians	You are attacking the Dolopians!	true
factions_defend_desc_troy_main_dan_dolopians	You are defending against the Dolopians!	true
factions_screen_name_when_shogun_troy_main_dan_dorians	placeholder	true
factions_clan_summary_name_when_shogun_troy_main_dan_miletus	placeholder	true
factions_clan_summary_name_when_shogun_troy_main_trj_mygdonians	placeholder	true
factions_senator_text_n_out_of_n_troy_main_trj_lycia		true
factions_screen_name_when_rebels_troy_main_dan_pylos_tutorial	Achaean Rebels	true
factions_screen_adjective_troy_main_trj_ilion	Hyrtacidae	true
factions_screen_name_when_rebels_troy_main_trj_hector	Hector's Loyalists	true
factions_senator_text_n_out_of_n_troy_main_dan_thessalians		true
factions_clan_summary_name_troy_main_dan_phlegra	placeholder	true
factions_attack_desc_troy_main_dan_phyllis	You are attacking Phyllis!	true
factions_senator_text_n_out_of_n_troy_amazons_trj_hippolyta		true
factions_attack_desc_troy_main_dan_pylos	You are attacking Pylos!	true
factions_clan_summary_name_troy_main_dan_ithaca	placeholder	true
factions_screen_name_when_rebels_troy_main_dan_anemoessa	Achaean Rebels	true
factions_defend_desc_troy_main_dan_ellopians	You are defending against the Ellopians!	true
factions_screen_adjective_troy_main_dan_salamis	Salamis	true
factions_screen_name_troy_main_trj_hector	Hector of Troy	true
factions_senator_text_n_out_of_n_troy_main_dan_arcadians_tutorial		true
factions_screen_adjective_troy_main_trj_manyan_phry	Manyan	true
factions_attack_desc_troy_main_dan_corinthians	You are attacking the Corinthians!	true
factions_defend_desc_troy_main_dan_minyes	You are defending against Minyes!	true
factions_screen_name_troy_main_dan_macednon	Macednon	true
factions_clan_summary_name_when_shogun_troy_main_trj_hector	placeholder	true
factions_screen_name_when_rebels_troy_main_dan_epidayrus	Achaean Rebels	true
factions_screen_name_when_rebels_troy_main_dan_argos	Argive Loyalists	true
factions_screen_name_troy_main_dan_minyes	Minyes	true
factions_screen_name_when_rebels_troy_main_trj_bisaltae	Thracian Rebels	true
factions_screen_name_when_rebels_troy_main_dan_makaria	Aeolian Rebels	true
factions_screen_name_when_rebels_troy_main_dan_dindyma	Aeolian Rebels	true
factions_senator_text_n_out_of_n_troy_main_dan_tiryns		true
factions_screen_name_troy_main_trj_paeonians	Paeonians	true
factions_clan_summary_name_troy_main_trj_hector_separatists	placeholder	true
factions_screen_name_when_rebels_troy_main_trj_ascanian_phry	Thracian Rebels	true
factions_screen_name_when_shogun_troy_main_dan_curetes	placeholder	true
factions_screen_name_when_rebels_troy_main_dan_phlegra	Ionian Rebels	true
factions_defend_desc_troy_main_dan_boeotians	You are defending against the Boeotians!	true
factions_clan_summary_name_troy_main_trj_lycia_separatists	placeholder	true
factions_screen_adjective_troy_main_dan_dindyma	Dindyma	true
factions_screen_adjective_troy_main_dan_noagria	Noagrian	true
factions_attack_desc_troy_main_dan_anemoessa	You are attacking Anemoessa!	true
factions_screen_name_troy_main_dan_abantes	Abantes	true
factions_screen_name_when_rebels_troy_main_dan_athina	Ionian Rebels	true
factions_screen_name_when_shogun_troy_main_dan_ephesos	placeholder	true
factions_clan_summary_name_troy_main_dan_sparta	placeholder	true
factions_screen_adjective_troy_main_dan_triopion	Triopion	true
factions_screen_name_when_shogun_troy_main_trj_alazones	placeholder	true
factions_defend_desc_troy_amazons_trj_penthesilea	You are defending against Penthesilea's Amazons!	true
factions_clan_summary_name_when_shogun_troy_main_dan_minyes	placeholder	true
factions_screen_adjective_troy_main_trj_dardania_separatists	Dardanian Nobles	true
factions_defend_desc_troy_main_trj_thrakes	You are defending against the Thrakes!	true
factions_attack_desc_troy_main_trj_imbrasos	You are attacking Ilion Imbrasos!	true
factions_screen_name_troy_main_dan_pylos_tutorial	Pylos	true
factions_screen_adjective_troy_main_trj_paphlagonians	Paphlagonian	true
factions_screen_adjective_troy_main_trj_carians	Carian	true
factions_screen_name_troy_main_dan_ellopians	Ellopians	true
factions_screen_name_troy_main_trj_tlawa	Tlawa	true
factions_screen_name_when_shogun_troy_main_trj_manyan_phry	placeholder	true
factions_senator_text_n_out_of_n_troy_main_dan_mycenae		true
factions_screen_name_when_rebels_troy_main_dan_minyes	Aeolian Rebels	true
factions_screen_name_when_rebels_troy_main_dan_dionysias	Achaean Rebels	true
factions_screen_name_troy_main_trj_paris_separatists	Trojan Royal Pretenders	true
factions_screen_adjective_troy_main_dan_rhodes	Rhodes	true
factions_defend_desc_troy_main_dan_ionian_rebels	You are defending against the Denyen of the Sea!	true
factions_defend_desc_troy_main_trj_troy	You are defending against Priam's Trojans!	true
factions_screen_name_troy_main_dan_ithaca	Ithaca	true
factions_screen_name_att_fact_red	Red	true
factions_clan_summary_name_when_shogun_troy_main_trj_alazones	placeholder	true
factions_screen_name_when_shogun_troy_main_trj_tereia	placeholder	true
factions_screen_name_when_shogun_troy_main_dan_ithaca_separatists	placeholder	true
factions_clan_summary_name_troy_main_dan_dorians	placeholder	true
factions_screen_adjective_troy_main_dan_makaria	Makaria	true
factions_attack_desc_troy_main_dan_aetolians	You are attacking the Aetolians!	true
factions_screen_adjective_troy_main_trj_methymna	Methymna	true
factions_screen_adjective_troy_main_dan_argos	Argive	true
factions_attack_desc_troy_main_dan_mycenae_separatists	You are attacking  the Mycenaean Noble Pretenders!	true
factions_senator_text_n_out_of_n_troy_main_trj_aegaan_pel		true
factions_clan_summary_name_troy_main_dan_phaiacians	placeholder	true
factions_defend_desc_troy_main_trj_mygdonians	You are defending against the Mygdonians!	true
factions_clan_summary_name_troy_main_dan_macednon	placeholder	true
factions_defend_desc_troy_main_dan_epirotes	You are defending against the Epirotes!	true
factions_clan_summary_name_troy_main_dan_minyes	placeholder	true
factions_screen_name_when_shogun_troy_main_trj_thrakes	placeholder	true
factions_clan_summary_name_when_shogun_troy_main_dan_meliboea	placeholder	true
factions_screen_name_when_rebels_troy_main_dan_cassopaei	Dorian Rebels	true
factions_attack_desc_troy_main_trj_aenos	You are attacking Aenos!	true
factions_defend_desc_troy_main_trj_dardania_separatists	You are defending against the Dardanian Noble Pretenders!	true
factions_screen_adjective_troy_main_dan_peraia	Peraian	true
factions_clan_summary_name_when_shogun_troy_main_trj_thrakes	placeholder	true
factions_screen_name_troy_main_dan_elis	Elis	true
factions_senator_text_n_out_of_n_troy_main_trj_cyclops		true
factions_screen_name_when_shogun_troy_amazons_trj_penthesilea	placeholder	true
factions_attack_desc_troy_main_dan_abantes	You are attacking the Abantes!	true
factions_defend_desc_troy_main_trj_bithyni	You are defending against the Bithyni tribe!	true
factions_clan_summary_name_when_shogun_troy_main_trj_paris_separatists	placeholder	true
factions_senator_text_n_out_of_n_troy_main_dan_graea		true
factions_screen_name_when_rebels_troy_main_dan_tiryns	Achaean Rebels	true
factions_clan_summary_name_when_shogun_troy_main_dan_pylos_tutorial	placeholder	true
factions_screen_name_troy_main_dan_aetolians	Aetolians	true
factions_screen_name_when_shogun_troy_main_trj_mygdonians	placeholder	true
factions_clan_summary_name_when_shogun_troy_main_trj_hector_separatists	placeholder	true
factions_screen_name_when_rebels_troy_main_dan_narykos	Aeolian Rebels	true
factions_screen_name_when_shogun_troy_main_trj_lelegan_rebels	placeholder	true
factions_clan_summary_name_troy_main_dan_pylos	placeholder	true
factions_defend_desc_troy_main_dan_corinthians	You are defending against the Corinthians!	true
factions_screen_name_troy_main_dan_phlegra	Phlegra	true
factions_clan_summary_name_when_shogun_troy_main_trj_cyclops	placeholder	true
factions_clan_summary_name_troy_main_dan_makaria	placeholder	true
factions_clan_summary_name_troy_main_trj_troy	placeholder	true
factions_clan_summary_name_troy_main_dan_knossos	placeholder	true
factions_attack_desc_troy_main_dan_aeolian_rebels	You are attacking the Shekelesh!	true
factions_clan_summary_name_when_shogun_troy_main_trj_troy	placeholder	true
factions_senator_text_n_out_of_n_troy_main_dan_rhodes		true
factions_screen_name_when_rebels_troy_main_trj_lycia_separatists	Lycian Noble Pretenders	true
factions_screen_name_troy_main_trj_maeonians	Maeonians	true
factions_defend_desc_troy_main_trj_apsynthioi	You are defending against the Apsynthioi tribe!	true
factions_senator_text_n_out_of_n_troy_main_trj_mysia		true
factions_screen_name_troy_main_dan_dorians	Dorians	true
factions_screen_name_troy_main_dan_apteron	Apteron	true
factions_senator_text_n_out_of_n_troy_main_trj_pelasgians_rebels		true
factions_screen_adjective_troy_main_dan_pylos_tutorial	Pylos	true
factions_screen_name_when_shogun_troy_main_dan_aeolian_rebels	placeholder	true
factions_screen_adjective_troy_main_dan_epidayrus	Epidaurian	true
factions_clan_summary_name_when_shogun_troy_main_trj_aethria	placeholder	true
factions_screen_name_troy_main_trj_aenos	Aenos	true
factions_screen_name_when_rebels_troy_main_dan_dorian_rebels	Dorian Rebels	true
factions_screen_adjective_troy_main_dan_arcadians_tutorial	Arcadian	true
factions_clan_summary_name_when_shogun_troy_main_dan_epirotes	placeholder	true
factions_clan_summary_name_when_shogun_troy_main_trj_pelasgiotes	placeholder	true
factions_attack_desc_troy_main_trj_mygdonians	You are attacking the Mygdonians!	true
factions_screen_adjective_troy_main_dan_tantalis	Tantalis	true
factions_clan_summary_name_when_shogun_troy_main_trj_aegaan_pel	placeholder	true
factions_screen_name_when_shogun_troy_main_dan_phaiacians	placeholder	true
factions_screen_adjective_troy_main_trj_maeonians	Maeonian	true
factions_defend_desc_troy_main_dan_dorians	You are defending against the Dorians!	true
factions_screen_name_when_shogun_troy_main_dan_perrhaebi	placeholder	true
factions_screen_adjective_troy_main_dan_dolopia	Dolopian	true
factions_screen_name_when_rebels_troy_main_dan_chersonesos	Aeolian Rebels	true
factions_screen_name_when_shogun_troy_main_dan_dolopians	placeholder	true
factions_clan_summary_name_troy_main_dan_ellopians	placeholder	true
factions_screen_name_when_shogun_troy_main_dan_apteron	placeholder	true
factions_clan_summary_name_when_shogun_troy_main_trj_lycia	placeholder	true
factions_screen_name_when_shogun_troy_main_dan_dindyma	placeholder	true
factions_clan_summary_name_troy_main_dan_antheada	placeholder	true
factions_screen_name_when_shogun_troy_main_dan_phyllis	placeholder	true
factions_attack_desc_troy_main_dan_cassopaei	You are attacking the Cassopaei tribe!	true
factions_screen_name_troy_main_dan_achilles	Phthia	true
factions_clan_summary_name_when_shogun_troy_main_dan_ithaca	placeholder	true
factions_attack_desc_troy_main_dan_meliboea	You are attacking Meliboea!	true
factions_screen_name_troy_main_trj_pelasgians_rebels	Peleset (Pelasgian Rebels)	true
factions_screen_name_troy_main_trj_alazones	Alazones	true
factions_senator_text_n_out_of_n_troy_main_trj_hector		true
factions_screen_name_att_fact_blue	Blue	true
factions_screen_adjective_troy_main_dan_knossos	Knossos	true
factions_screen_name_troy_main_dan_mycenae	Mycenae	true
factions_clan_summary_name_when_shogun_troy_main_dan_rhodes	placeholder	true
factions_screen_name_when_shogun_troy_main_dan_corinthians	placeholder	true
factions_screen_name_when_shogun_troy_main_dan_knossos	placeholder	true
factions_screen_adjective_troy_main_dan_cassopaei	Cassopaeian	true
factions_defend_desc_troy_main_trj_tlawa	You are defending against Tlawa!	true
factions_screen_name_troy_main_trj_bottiaeans	Bottiaeans	true
factions_defend_desc_troy_main_dan_ephesos	You are defending against Ephesos!	true
factions_screen_name_when_shogun_troy_main_dan_dionysias	placeholder	true
factions_attack_desc_troy_main_trj_maeonians	You are attacking the Maeonians!	true
factions_clan_summary_name_troy_main_trj_paphlagonians	placeholder	true
factions_attack_desc_troy_main_dan_argos	You are attacking Argos!	true
factions_defend_desc_troy_main_dan_ithaca	You are defending against Ithaca!	true
factions_screen_name_troy_main_dan_ephesos	Ephesos	true
factions_clan_summary_name_troy_main_trj_lelegia_min	placeholder	true
factions_defend_desc_troy_main_dan_kyme	You are defending against Kyme!	true
factions_senator_text_n_out_of_n_troy_main_dan_ithaca		true
factions_screen_name_troy_main_trj_paris	Paris of Troy	true
factions_attack_desc_troy_main_dan_sparta	You are attacking Sparta!	true
factions_screen_name_when_rebels_troy_main_trj_lelegia_min	Lelegan Rebels	true
factions_clan_summary_name_when_shogun_troy_main_dan_dolopians	placeholder	true
factions_clan_summary_name_troy_main_dan_achilles	placeholder	true
factions_clan_summary_name_when_shogun_troy_main_dan_salamis	placeholder	true
factions_clan_summary_name_troy_main_trj_bisaltae	placeholder	true
factions_screen_name_when_rebels_troy_main_dan_magnetes	Aeolian Rebels	true
factions_senator_text_n_out_of_n_troy_main_trj_troy		true
factions_screen_name_troy_main_dan_peraia	Peraia	true
factions_screen_name_troy_main_dan_meliboea	Meliboea	true
factions_defend_desc_troy_main_dan_salamis	You are defending against Salamis!	true
factions_screen_name_when_rebels_troy_amazons_trj_penthesilea	Amazon Rebels	true
factions_senator_text_n_out_of_n_troy_main_trj_thrakes		true
factions_screen_name_troy_main_dan_dionysias	Dionysias	true
factions_screen_name_when_shogun_att_fact_blue	placeholder	true
factions_screen_name_troy_main_trj_thyni	Thyni	true
factions_screen_adjective_troy_main_dan_thessalians	Thessalian	true
factions_senator_text_n_out_of_n_troy_main_trj_bithyni		true
factions_senator_text_n_out_of_n_troy_main_dan_epirotes		true
factions_attack_desc_troy_main_trj_bithyni	You are attacking the Bithyni tribe!	true
factions_attack_desc_troy_main_dan_epirotes	You are attacking the Epirotes!	true
factions_screen_adjective_troy_main_trj_bithyni	Bithynian	true
factions_screen_name_troy_main_trj_lycia	Lycia	true
factions_defend_desc_troy_main_dan_epidayrus	You are defending against Epidayrus!	true
factions_defend_desc_att_fact_red	You are defending against Red Shield!	true
factions_screen_name_troy_main_dan_anemoessa	Anemoessa	true
factions_clan_summary_name_troy_main_dan_achaean_rebels	placeholder	true
factions_screen_adjective_att_fact_red	Red	true
factions_screen_name_when_shogun_troy_main_dan_peraia	placeholder	true
factions_screen_adjective_troy_main_trj_tereia	Tereia	true
factions_clan_summary_name_troy_main_dan_salamis	placeholder	true
factions_screen_name_troy_main_trj_edonia	Edonia	true
factions_screen_name_troy_main_trj_bisaltae	Bisaltae	true
factions_screen_name_when_shogun_troy_main_dan_arcadians_tutorial	placeholder	true
factions_senator_text_n_out_of_n_troy_main_dan_boeotians		true
factions_attack_desc_troy_main_dan_peraia	You are attacking Peraia!	true
factions_senator_text_n_out_of_n_troy_main_dan_apaesos		true
factions_senator_text_n_out_of_n_troy_main_trj_bottiaeans		true
factions_clan_summary_name_when_shogun_troy_main_trj_manyan_phry	placeholder	true
factions_defend_desc_troy_main_dan_elis	You are defending against Elis!	true
factions_clan_summary_name_when_shogun_troy_main_dan_ithaca_separatists	placeholder	true
factions_attack_desc_troy_main_trj_tlawa	You are attacking Tlawa!	true
factions_attack_desc_troy_main_dan_ephesos	You are attacking Ephesos!	true
factions_screen_name_troy_main_dan_triopion	Triopion	true
factions_screen_name_when_shogun_troy_main_trj_tlawa	placeholder	true
factions_senator_text_n_out_of_n_troy_main_trj_lelegan_rebels		true
factions_screen_adjective_troy_main_dan_dorian_rebels	Dorian	true
factions_clan_summary_name_troy_main_dan_mycenae	placeholder	true
factions_screen_adjective_troy_main_trj_cicones	Ciconian	true
factions_screen_adjective_troy_main_dan_macednon	Macednon	true
factions_attack_desc_troy_main_dan_triopion	You are attacking Triopion!	true
factions_senator_text_n_out_of_n_troy_main_dan_esperia		true
factions_defend_desc_troy_main_dan_abantes	You are defending against the Abantes!	true
factions_screen_adjective_troy_main_trj_lycia	Lycian	true
factions_senator_text_n_out_of_n_troy_main_dan_noagria		true
factions_defend_desc_troy_main_dan_ozolian_loc	You are defending against Ozolian Locris!	true
factions_senator_text_n_out_of_n_troy_main_dan_elis		true
factions_screen_adjective_troy_main_dan_ellopians	Ellopian	true
factions_senator_text_n_out_of_n_troy_main_dan_tantalis		true
factions_clan_summary_name_troy_main_trj_maeonians_tml	placeholder	true
factions_clan_summary_name_troy_main_trj_lycia	placeholder	true
factions_clan_summary_name_when_shogun_troy_main_trj_carians	placeholder	true
factions_clan_summary_name_troy_main_dan_lapiths	placeholder	true
factions_defend_desc_troy_main_trj_pelasgians_rebels	You are defending against the Peleset (Pelasgian Rebels)!	true
factions_senator_text_n_out_of_n_troy_main_dan_mycenae_separatists		true
factions_screen_name_when_shogun_att_fact_yellow	placeholder	true
factions_screen_adjective_troy_main_dan_phyllis	Phyllis	true
factions_screen_name_when_rebels_troy_main_dan_teleboans	Achaean Rebels	true
factions_senator_text_n_out_of_n_troy_main_dan_dorian_rebels		true
factions_clan_summary_name_when_shogun_troy_main_dan_ephesos	placeholder	true
factions_clan_summary_name_when_shogun_troy_main_trj_lelegan_rebels	placeholder	true
factions_clan_summary_name_att_fact_red	placeholder	true
factions_senator_text_n_out_of_n_troy_main_dan_achilles		true
factions_screen_name_when_shogun_troy_main_dan_meliboea	placeholder	true
factions_clan_summary_name_troy_main_trj_paris	placeholder	true
factions_attack_desc_troy_main_dan_achaean_rebels	You are attacking the Danaan Rebels!	true
factions_screen_adjective_troy_main_dan_phlegra	Phlegra	true
factions_defend_desc_troy_main_dan_achilles_separatists	You are defending against the Phthian Noble Pretenders!	true
factions_screen_name_when_rebels_troy_main_dan_achilles	Phthian Loyalists	true
factions_screen_name_when_shogun_troy_main_dan_achaean_rebels	placeholder	true
factions_defend_desc_troy_main_dan_arcadians	You are defending against the Arcadians!	true
factions_screen_adjective_troy_main_dan_aeolian_rebels	Aeolian	true
factions_senator_text_n_out_of_n_troy_main_dan_meliboea		true
factions_screen_name_troy_main_trj_bithyni	Bithyni	true
factions_screen_name_when_shogun_troy_main_dan_rhodes	placeholder	true
factions_clan_summary_name_troy_main_dan_aeolian_rebels	placeholder	true
factions_senator_text_n_out_of_n_troy_main_dan_ithaca_separatists		true
factions_attack_desc_troy_main_dan_ionia	You are attacking Ionia!	true
factions_clan_summary_name_troy_main_dan_epidayrus	placeholder	true
factions_screen_name_troy_main_dan_teleboans	Teleboans	true
factions_clan_summary_name_when_shogun_troy_main_trj_ilion	placeholder	true
factions_screen_adjective_troy_main_trj_paeonians	Paeonian	true
factions_senator_text_n_out_of_n_troy_main_dan_chersonesos		true
factions_senator_text_n_out_of_n_troy_main_dan_triopion		true
factions_senator_text_n_out_of_n_troy_main_dan_abantes		true
factions_screen_name_when_shogun_troy_main_dan_macednon	placeholder	true
factions_screen_name_troy_main_trj_ascanian_phry	Ascanian Phrygians	true
factions_screen_name_troy_main_dan_arcadians	Arcadians	true
factions_clan_summary_name_troy_main_dan_elis	placeholder	true
factions_screen_name_troy_main_dan_asia	Asia	true
factions_clan_summary_name_troy_main_trj_thrakes	placeholder	true
factions_screen_name_when_shogun_troy_main_dan_magnetes	placeholder	true
factions_screen_name_when_shogun_troy_main_trj_lelegia_min	placeholder	true
factions_clan_summary_name_when_shogun_troy_main_trj_dardania	placeholder	true
factions_attack_desc_troy_main_dan_knossos	You are attacking Knossos!	true
factions_screen_adjective_troy_main_dan_kyme	Kyme	true
factions_clan_summary_name_troy_main_dan_curetes	placeholder	true
factions_attack_desc_troy_main_dan_achilles_separatists	You are attacking  the Phthian Noble Pretenders!	true
factions_screen_name_troy_main_trj_maeonians_tml	Maeonians of Tmolos	true
factions_defend_desc_troy_main_trj_thyni	You are defending against the Thyni tribe!	true
factions_screen_name_when_rebels_troy_main_trj_dardania_separatists	Dardanian Noble Pretenders	true
factions_attack_desc_troy_main_trj_agriophones	You are attacking the Agriophones tribe!	true
factions_screen_name_when_rebels_troy_main_dan_sparta	Spartan Loyalists	true
factions_defend_desc_troy_main_trj_lycia	You are defending against Lycia!	true
factions_clan_summary_name_when_shogun_troy_main_trj_cicones	placeholder	true
factions_clan_summary_name_when_shogun_troy_main_trj_thracian_rebels	placeholder	true
factions_attack_desc_troy_main_dan_arcadians_tutorial	You are attacking the Arcadians!	true
factions_attack_desc_troy_main_trj_aegaan_pel	You are attacking the Aegaan Pelasgians!	true
factions_clan_summary_name_troy_main_dan_apaesos	placeholder	true
factions_clan_summary_name_troy_main_dan_thessalians	placeholder	true
factions_attack_desc_troy_main_dan_ithaca_separatists	You are attacking  the Ithacan Noble Pretenders!	true
factions_screen_name_when_shogun_troy_main_dan_aetolians	placeholder	true
factions_screen_name_when_rebels_troy_main_dan_ozolian_loc	Aeolian Rebels	true
factions_screen_name_troy_main_trj_apsynthioi	Apsynthioi	true
factions_attack_desc_troy_main_dan_curetes	You are attacking the Curetes!	true
factions_screen_name_troy_main_trj_aethria	Aethria	true
factions_screen_name_when_shogun_troy_main_dan_dorian_rebels	placeholder	true
factions_attack_desc_troy_main_dan_apaesos	You are attacking Apaesos!	true
factions_screen_name_when_rebels_troy_main_dan_mycenae_separatists	Mycenaean Noble Pretenders	true
factions_defend_desc_troy_main_dan_magnetes	You are defending against the Magnetes!	true
factions_screen_adjective_troy_main_dan_aetolians	Aetolian	true
factions_senator_text_n_out_of_n_troy_main_trj_aenos		true
factions_screen_name_when_rebels_troy_main_dan_macednon	Dorian Rebels	true
factions_screen_name_troy_main_dan_mycenae_separatists	Mycenaean Noble Pretenders	true
factions_senator_text_n_out_of_n_troy_amazons_trj_penthesilea		true
factions_clan_summary_name_when_shogun_troy_main_trj_ascanian_phry	placeholder	true
factions_clan_summary_name_troy_main_trj_hector	placeholder	true
factions_attack_desc_troy_main_dan_sparta_separatists	You are attacking  the Spartan Noble Pretenders!	true
factions_screen_adjective_troy_main_trj_lycia_separatists	Lycian Nobles	true
factions_attack_desc_troy_main_dan_miletus	You are attacking Miletus!	true
factions_clan_summary_name_troy_main_dan_arcadians_tutorial	placeholder	true
factions_clan_summary_name_when_shogun_troy_main_trj_tereia	placeholder	true
factions_defend_desc_troy_main_trj_hector_separatists	You are defending against the Trojan Noble Pretenders!	true
factions_attack_desc_troy_main_trj_paris	You are attacking Paris' Trojans!	true
factions_screen_name_when_shogun_troy_main_dan_anemoessa	placeholder	true
factions_clan_summary_name_when_shogun_troy_main_dan_apaesos	placeholder	true
factions_screen_adjective_troy_main_dan_pylos	Pylos	true
factions_defend_desc_troy_main_dan_chersonesos	You are defending against Chersonesos!	true
factions_clan_summary_name_when_shogun_troy_main_dan_noagria	placeholder	true
factions_screen_name_troy_main_dan_dolopians	Lycomedes' Dolopians	true
factions_screen_name_when_shogun_troy_main_dan_troizen	placeholder	true
factions_screen_name_troy_main_trj_dardania_separatists	Dardanian Pretenders	true
factions_screen_name_troy_main_dan_graea	Graea	true
factions_screen_adjective_troy_main_dan_magnetes	Magnetean	true
factions_screen_name_troy_main_dan_dorian_rebels	Dorian Rebels	true
factions_screen_name_when_shogun_troy_main_trj_edonia	placeholder	true
factions_attack_desc_troy_main_trj_pelasgiotes	You are attacking the Pelasgiotes!	true
factions_clan_summary_name_when_shogun_troy_main_trj_maeonian_rebels	placeholder	true
factions_clan_summary_name_troy_main_dan_ithaca_separatists	placeholder	true
factions_attack_desc_troy_main_trj_mysia	You are attacking Mysia!	true
factions_clan_summary_name_when_shogun_troy_main_dan_dorians	placeholder	true
factions_clan_summary_name_when_shogun_troy_main_trj_bisaltae	placeholder	true
factions_clan_summary_name_when_shogun_troy_main_trj_mysia	placeholder	true
factions_screen_adjective_troy_main_dan_teleboans	Teleboan	true
factions_clan_summary_name_when_shogun_troy_main_dan_ionian_rebels	placeholder	true
factions_screen_adjective_troy_main_dan_abantes	Abantan	true
factions_clan_summary_name_when_shogun_troy_main_dan_aetolians	placeholder	true
factions_attack_desc_troy_main_trj_tereia	You are attacking Tereia!	true
factions_screen_name_when_rebels_troy_main_dan_triopion	Achaean Rebels	true
factions_clan_summary_name_troy_main_trj_ascanian_phry	placeholder	true
factions_screen_name_troy_main_dan_apaesos	Apaesos	true
factions_clan_summary_name_when_shogun_troy_main_dan_triopion	placeholder	true
factions_senator_text_n_out_of_n_troy_main_dan_argos		true
factions_screen_name_when_rebels_troy_main_dan_corinthians	Ionian Rebels	true
factions_senator_text_n_out_of_n_troy_main_trj_paris_separatists		true
factions_clan_summary_name_troy_main_trj_aegaan_pel	placeholder	true
factions_screen_name_troy_main_trj_dardania	Dardania	true
factions_screen_adjective_troy_main_trj_alazones	Alazonian	true
factions_attack_desc_troy_main_trj_troy	You are attacking Priam's Trojans!	true
factions_clan_summary_name_when_shogun_troy_main_trj_pelasgians_rebels	placeholder	true
factions_screen_adjective_troy_main_trj_edonia	Edonian	true
factions_defend_desc_att_fact_blue	You are defending against Red Shield!	true
factions_screen_name_when_shogun_troy_main_dan_lapiths	placeholder	true
factions_clan_summary_name_troy_main_dan_epirotes	placeholder	true
factions_senator_text_n_out_of_n_troy_main_dan_pylos_tutorial		true
factions_screen_name_when_rebels_troy_main_dan_perrhaebi	Aeolian Rebels	true
factions_screen_name_troy_main_dan_makaria	Makaria	true
factions_screen_adjective_troy_main_trj_apsynthioi	Apsynthian	true
factions_screen_name_troy_main_trj_carians	Carians	true
factions_clan_summary_name_when_shogun_troy_main_dan_narykos	placeholder	true
factions_screen_adjective_troy_main_dan_minyes	Minyes	true
factions_clan_summary_name_when_shogun_troy_main_dan_aeolian_rebels	placeholder	true
factions_attack_desc_troy_main_dan_dorians	You are attacking the Dorians!	true
factions_attack_desc_troy_main_trj_paphlagonians	You are attacking the Paphlagonians!	true
factions_screen_name_when_shogun_troy_main_trj_maeonian_rebels	placeholder	true
factions_clan_summary_name_when_shogun_troy_main_dan_graea	placeholder	true
factions_screen_adjective_troy_main_dan_phaiacians	Phaiacian	true
factions_defend_desc_troy_main_dan_asia	You are defending against Asia!	true
factions_screen_name_when_rebels_troy_main_dan_lapiths	Aeolian Rebels	true
factions_clan_summary_name_when_shogun_troy_main_dan_esperia	placeholder	true
factions_screen_adjective_troy_main_trj_maeonian_rebels	Maeonian	true
factions_clan_summary_name_when_shogun_troy_main_dan_lapiths	placeholder	true
factions_defend_desc_troy_main_dan_dindyma	You are defending against Dindyma!	true
factions_screen_adjective_troy_main_dan_sparta	Spartan	true
factions_defend_desc_troy_main_dan_miletus	You are defending against Miletus!	true
factions_screen_name_when_rebels_troy_main_dan_dorians	Dorian Rebels	true
factions_clan_summary_name_troy_main_dan_noagria	placeholder	true
factions_clan_summary_name_troy_main_trj_edonia	placeholder	true
factions_clan_summary_name_troy_main_trj_paris_separatists	placeholder	true
factions_screen_adjective_troy_main_trj_thyni	Thynian	true
factions_screen_name_troy_main_trj_thracian_rebels	Unruly Thracians	true
factions_screen_name_when_shogun_troy_main_dan_pylos_tutorial	placeholder	true
factions_screen_name_when_rebels_troy_main_dan_rhodes	Achaean Rebels	true
factions_screen_adjective_troy_main_dan_mycenae_separatists	Mycenaean Nobles	true
factions_attack_desc_troy_main_dan_arcadians	You are attacking the Arcadians!	true
factions_screen_name_when_rebels_troy_main_trj_lycia	Lycian Loyalists	true
factions_screen_name_troy_main_dan_curetes	Curetes	true
factions_screen_name_when_rebels_troy_main_dan_thessalians	Aeolian Rebels	true
factions_screen_name_when_shogun_troy_main_trj_apsynthioi	placeholder	true
factions_clan_summary_name_when_shogun_troy_main_trj_paphlagonians	placeholder	true
factions_attack_desc_troy_main_dan_noagria	You are attacking Noagria!	true
factions_defend_desc_troy_main_dan_makaria	You are defending against Makaria!	true
factions_screen_name_when_rebels_troy_main_dan_dolopians	Aeolian Rebels	true
factions_senator_text_n_out_of_n_troy_main_dan_makaria		true
factions_screen_name_troy_main_dan_knossos	Knossos	true
factions_defend_desc_troy_main_dan_knossos	You are defending against Knossos!	true
factions_defend_desc_troy_main_trj_paeonians	You are defending against the Paeonians!	true
factions_screen_name_when_rebels_troy_main_trj_maeonians_tml	Maeonian Rebels	true
factions_senator_text_n_out_of_n_troy_main_trj_thyni		true
factions_attack_desc_troy_main_dan_thessalians	You are attacking the Thessalians!	true
factions_screen_adjective_troy_main_trj_lelegia_min	Lelegan	true
factions_screen_name_when_shogun_troy_main_trj_paphlagonians	placeholder	true
factions_screen_name_when_rebels_troy_main_trj_tlawa	Lelegan Rebels	true
factions_senator_text_n_out_of_n_troy_main_dan_pylos		true
factions_attack_desc_troy_main_dan_minyes	You are attacking Minyes!	true
factions_senator_text_n_out_of_n_troy_main_dan_narykos		true
factions_screen_name_troy_main_dan_esperia	Esperia	true
factions_defend_desc_troy_main_dan_troizen	You are defending against Troizen!	true
factions_clan_summary_name_troy_main_dan_dolopians	placeholder	true
factions_attack_desc_troy_main_trj_paeonians	You are attacking the Paeonians!	true
factions_clan_summary_name_when_shogun_troy_main_dan_anemoessa	placeholder	true
factions_defend_desc_troy_main_trj_alazones	You are defending against the Alazones!	true
factions_clan_summary_name_troy_main_dan_ozolian_loc	placeholder	true
factions_attack_desc_troy_main_trj_apsynthioi	You are attacking the Apsynthioi tribe!	true
factions_screen_name_when_shogun_troy_main_dan_mycenae	placeholder	true
factions_screen_name_troy_main_dan_aethaleia	Aethaleia	true
factions_screen_name_when_rebels_troy_main_dan_kyme	Aeolian Rebels	true
factions_screen_name_when_rebels_troy_main_trj_methymna	Pelasgian Rebels	true
factions_screen_name_when_rebels_troy_main_dan_aetolians	Achaean Rebels	true
factions_clan_summary_name_when_shogun_troy_main_dan_pylos	placeholder	true
factions_attack_desc_troy_main_trj_dardania	You are attacking Dardania!	true
factions_screen_name_when_rebels_troy_main_dan_mycenae	Mycenaean Loyalists	true
factions_defend_desc_troy_main_trj_aegaan_pel	You are defending against the Aegaan Pelasgians!	true
factions_attack_desc_troy_main_trj_lycia	You are attacking Lycia!	true
factions_defend_desc_troy_main_trj_maeonian_rebels	You are defending against the Maeonian Rebels!	true
factions_attack_desc_troy_main_dan_achilles	You are attacking Phthia!	true
factions_clan_summary_name_when_shogun_troy_main_trj_edonia	placeholder	true
factions_clan_summary_name_troy_main_trj_dardania_separatists	placeholder	true
factions_screen_name_when_shogun_troy_main_dan_mycenae_separatists	placeholder	true
factions_attack_desc_att_fact_yellow	You are attacking Red Shield!	true
factions_screen_name_troy_main_dan_boeotians	Boeotians	true
factions_defend_desc_troy_main_dan_triopion	You are defending against Triopion!	true
factions_clan_summary_name_troy_main_trj_cicones	placeholder	true
factions_screen_adjective_troy_main_dan_corinthians	Corinthian	true
factions_screen_adjective_troy_main_trj_troy	Trojan	true
